*+++++++++++++++++++++++++++++++++++++++++*
*         x--x--x--x           H = Healer *
*        /   |  |  |                      *
*       /    |  |  |                      * 
*      x     x--x--x--x--x                *
*     /      |  |  |     |                *
*    /       |  |  |     |                *
*   x     x--x--x--x     x                *
*   |     |  |  |  |                      *
*   |     |  |  |  |                      *
*   x--x--x--x--x--x                      * 
*   |  |  |   \ |  |                      *
*   |  |  |    \|  |                      * 
*   x--x--x     x--x--x                   *   
*   |     |     |     |                   *
*   |     |     |     |                   *
*   x     H  x--x     x--x                *
*  /         |  |                         *
* /          |  |                         *
*x--x--x--x--x--x                         *
*+++++++++++++++++++++++++++++++++++++++++*
