+++++++++++++++++++++++++++++++
*                             *
*  1-1                   2-2  *
*  | |                   | |  *
*  1-1-#-#-#-#-#-#-#-#-#-2-2  *
*    |                   |    *
*    # x x x x x x x x x #    *
*    |                   |    *
*    # x x m-m-m-m-m x x #    *
*    |     |       |     |    *
*    # x x m f f f m x x #    *
*    |     |       |     |    *
*    # x x m f f f m x x #    * 
*    |     |       |     |    * 
*    # x x m f f f m x x #    *
*    |     |       |     |    *
*    # x x m-m-d-m-m x x #    *
*    |         |         |    *
*    # x x x x x x x x x #    *
*    |                   |    *
*    # x x x x x x x x x #    *
*    |                   |    *
*  3-3-#-#-#-5-5-5-#-#-#-4-4  *
*  | |       | | |       | |  *
*  3-3       5-5-5       4-4  *
*                             *
+++++++++++++++++++++++++++++++

1 northwest tower
2 northeast tower
3 southwest tower
4 southeast tower
5 gatehouse
m moat
d drawbridge
f fortress
x courtyard

