
         The southern part of Silvere


       .    x-x-x-x-x-x-x-x-x-x-x    .
       .              |              .
    ..................x..................
       .              |              .
       .              x              .
       .              |              .
       .              x              .
       .              |              .
       .              x              .
       .              |              .
       .              x              .
       .              |              .
       .              x              .
       .              |              .
       .              x              .
       .              |              .
       .              x              .
       .              |              .
       .              x              .
       .              |              .
     -x-x-x-x-x-x-x-x-x              .
       .              |              .
    *  .              x              .
     * .              |              .
      ****************x***************       
                      |
               outside the city
                  of Silvere
